107
8
34 0 0 0 0 0 0 0 0 0 0 0 0 0 0 0 0 0 0 0 0 0 0 0 0 0 0 0 0 0 0 0 0 0 0 0 0 0 0 0 0 0 0 0 0 0 0 0 0 0 0 0 0 0 0 0 0 0 0 0 0 0 0 0 0 0 0 0 0 0 0 30 33 33 33 33 33 33 33 33 33 33 33 33 33 33 33 33 33 33 34 0 0 0 0 0 0 0 0 0 0 0 0 0 0 0 30
34 0 0 0 0 0 0 0 0 0 0 0 0 0 0 0 0 0 0 0 0 0 0 0 0 0 0 0 0 0 0 0 0 0 0 0 0 0 0 0 0 0 0 0 0 0 0 0 0 0 0 0 0 0 0 0 0 0 0 0 0 0 0 0 0 0 0 0 0 0 0 13 30 33 33 33 33 33 33 33 33 33 33 33 33 33 33 33 33 33 13 0 0 0 0 0 0 0 0 0 0 0 0 0 0 0 30
34 0 0 0 0 0 0 0 0 0 0 0 0 0 0 0 0 0 0 0 0 0 0 0 0 0 0 0 0 0 0 0 0 0 0 0 0 0 0 0 0 0 0 0 0 0 0 0 0 0 0 0 0 0 0 0 0 0 0 0 0 0 0 0 0 0 0 0 0 0 0 0 30 34 13 30 33 33 33 33 33 33 33 33 33 33 33 34 13 13 0 0 0 0 0 0 0 0 0 0 0 0 0 0 0 0 30
34 0 0 0 0 0 0 0 0 0 0 0 0 0 0 0 0 0 0 0 0 0 0 0 31 32 0 0 0 0 0 0 0 0 0 0 0 0 0 0 0 0 0 0 0 0 0 0 0 0 0 0 0 0 0 0 0 0 0 0 0 0 0 0 0 0 0 0 0 0 0 0 13 13 0 30 33 33 33 33 33 33 33 33 33 33 33 13 0 0 0 0 0 0 0 0 0 0 0 0 0 0 0 0 0 0 30
34 0 0 0 0 0 0 0 0 0 0 0 0 0 0 0 0 0 22 0 0 0 21 0 0 0 0 0 0 0 0 0 0 0 0 0 0 0 0 0 0 0 0 0 0 0 0 31 32 0 0 0 22 23 23 21 0 0 0 0 0 0 0 0 0 0 0 0 0 0 0 0 0 0 0 13 10 5 5 5 5 5 5 5 5 5 9 0 0 0 0 0 0 0 0 0 0 0 0 0 0 0 0 0 0 0 30
34 0 0 0 0 0 0 0 0 0 0 0 0 31 32 0 0 0 30 23 23 23 34 0 0 0 0 0 0 3 0 23 0 0 0 0 0 0 0 0 0 0 23 0 3 3 0 0 0 0 0 0 30 33 33 34 0 0 0 0 0 0 0 0 0 0 0 0 0 0 0 0 0 0 0 0 16 11 11 11 11 11 11 11 11 11 15 0 0 0 0 0 0 0 0 0 0 0 0 0 0 0 0 0 0 0 30
34 0 0 0 0 0 0 0 0 0 0 0 0 0 0 0 0 0 30 33 33 33 34 0 0 0 25 23 23 23 23 33 23 21 27 28 28 28 28 28 29 22 33 23 23 23 0 0 0 0 0 0 30 33 33 34 0 31 32 0 0 0 3 0 0 23 0 0 0 0 0 0 0 0 0 0 7 14 14 14 14 14 14 14 14 14 6 0 0 0 0 0 0 22 21 0 0 22 21 0 3 0 0 0 0 0 30
33 22 23 23 23 23 23 23 23 23 23 21 0 0 0 0 0 0 30 33 33 33 34 0 0 0 0 30 33 33 33 33 33 34 0 0 0 0 0 0 0 30 33 33 33 33 22 23 23 23 23 21 30 33 33 34 0 0 0 0 0 0 22 23 23 33 23 23 27 28 28 28 28 28 29 23 39 39 39 39 39 39 39 39 39 39 39 23 23 23 23 23 23 33 33 23 23 33 33 23 23 23 23 23 23 21 33
