107
8
27 0 0 0 0 0 0 0 0 0 0 0 0 0 0 0 0 0 0 0 0 0 0 0 0 0 0 0 0 0 0 0 0 0 0 0 0 0 0 0 0 0 0 0 0 0 0 0 0 0 0 0 0 5 5 5 5 0 0 0 0 0 0 38 39 38 39 38 39 38 39 38 39 38 39 38 39 0 0 0 0 0 5 0 5 0 0 0 0 0 0 0 0 0 0 0 0 0 0 0 0 0 0 0 0 0 36
27 0 0 0 0 0 0 0 0 0 0 0 0 0 0 0 0 0 0 0 0 0 0 0 0 0 0 0 0 0 0 0 0 0 0 0 0 0 0 0 0 0 0 0 0 0 0 0 0 0 0 0 0 5 5 5 5 0 0 0 0 0 0 38 39 38 39 38 39 38 39 38 39 38 39 0 0 0 0 0 0 0 5 0 5 0 0 0 0 0 0 0 0 0 0 0 0 0 0 0 0 0 0 0 0 0 36
27 0 0 0 0 0 2 0 0 0 0 0 0 0 0 0 0 0 0 0 0 0 2 0 3 0 0 0 0 0 0 0 0 0 0 0 0 0 0 0 0 0 0 0 0 0 0 0 0 0 0 0 0 5 5 5 5 0 0 0 0 0 0 0 0 38 39 38 39 38 39 38 39 0 0 0 0 0 0 0 0 0 5 0 5 0 0 0 0 0 0 0 0 0 0 0 0 0 0 0 0 0 0 0 0 0 36
27 0 0 0 0 0 0 0 0 0 0 25 26 0 0 0 0 0 0 0 0 0 0 0 0 0 0 0 0 0 0 0 0 0 0 3 3 0 0 0 0 0 0 0 0 0 0 0 0 0 0 0 0 5 5 5 5 0 0 3 0 0 0 0 0 0 0 0 0 38 39 0 0 0 2 0 0 0 0 0 0 0 5 0 5 0 0 0 0 0 0 0 0 0 0 0 0 0 25 26 0 0 0 0 0 0 36
27 0 0 0 0 0 0 0 0 0 0 0 0 0 0 0 0 0 0 33 0 0 0 0 0 0 0 0 0 0 0 0 0 33 0 0 0 0 0 0 0 0 0 0 2 3 3 0 0 0 0 0 0 5 5 5 5 0 0 0 0 0 0 0 0 0 0 0 0 0 0 0 0 0 0 0 0 0 0 0 0 0 5 0 5 0 0 0 0 2 3 3 0 0 0 0 0 0 0 0 0 0 0 0 0 0 36
27 0 0 0 0 0 25 26 25 26 0 0 0 0 0 0 0 0 0 31 33 33 29 29 29 29 29 29 29 29 29 29 29 31 0 0 0 0 0 0 0 0 0 0 0 0 0 0 0 0 0 0 33 33 33 33 33 33 0 0 0 33 0 0 0 0 33 0 0 0 0 0 0 0 0 0 0 0 0 0 0 0 5 0 5 0 0 0 0 0 0 0 0 0 0 25 26 0 0 0 0 0 0 0 0 0 36
27 0 0 0 0 0 0 0 0 0 0 0 0 0 0 0 33 33 33 31 31 31 0 0 0 0 0 0 0 0 0 0 0 31 0 25 26 0 0 0 0 0 0 0 0 0 0 33 0 0 0 33 31 31 31 31 31 31 0 0 0 31 33 33 33 33 31 0 0 0 0 0 33 0 0 0 33 0 0 0 0 0 5 0 5 0 0 0 0 0 0 0 0 0 0 0 0 0 0 0 0 0 0 0 0 0 36
33 21 22 23 24 23 0 0 0 0 0 0 0 0 33 33 31 31 31 31 31 31 0 0 0 0 0 0 0 0 0 0 0 31 0 0 0 0 0 0 21 22 23 24 23 0 0 31 33 33 33 31 31 31 31 31 31 31 0 0 0 31 31 31 31 31 31 21 22 23 24 23 31 21 22 23 31 0 0 0 0 21 22 23 24 23 0 0 0 33 29 29 29 33 0 0 0 0 0 0 33 33 33 33 33 33 33
